# Dungeon StoneAge level-2 map 20x11
····················
····▓▓▓······•······
···▓▓•→········◄····
···▓••▓▓••▓▓········
···▓••⧛⧛⧛••▓▓·······
···▓••▓▓▓•••▓·······
···▓▓•▓·▓▓•••↕······
····▓▓▓··▓▓•••▓·····
··········▓▓•►▓·····
···········▓▓▓▓·····
····················
