# Dungeon StoneAge level-4 map 20x11
··▓▓▓▓▓·············
··▓···▓·▓▓▓·········
··▓▓▓·▓▓▓◄▓····▓▓▓··
····▓·····▓▓▓▓▓▓·▓··
····▓▓········▓··▓··
··▓▓▓···········▓▓··
··▓···········▓·▓···
··▓✥▓▓▓▓······▓▓▓···
··▓►▓··▓▓▓▓···▓·····
··▓▓▓·····▓▓▓▓▓·····
····················
