# Dungeon StoneAge level-6 map 20x11
····················
···▓▓▓·▓▓▓▓▓▓▓······
···▓◄•▓▓·····▓▓▓▓▓··
···▓••·←·▓••···←·▓··
····▓↓·•··←·▓↑··▓▓··
····▓·→·····••··▓···
···▓▓·•··▓▓▓▓▓·•▓···
···▓·····←••···←•▓··
···▓▓▓▓▓·····▓▓•►▓··
·······▓▓▓▓▓▓▓·▓▓▓··
····················
