# Dungeon StoneAge level-7 map 20x11
··················↕·
····················
····▓▓▓·········▓···
···▓▓•►·▓······▓•▓↕·
··▓▓•••▓•······▓••·▓
··▓•••••••····▓••◄·▓
··▓▓•••••······▓•···
···▓▓••↔···→········
····▓▓▓▓▓···········
······▓·············
·················↕··
