# Dungeon StoneAge level-8 map 20x11
···················▓
··▓▓▓····▓▓········▓
··▓▓▓···▓↓↓▓·······▓
··▓▓▓··▓↓··↓▓·······
······▓··←↓←·▓······
·····▓···→··▓·▓··▓▓▓
····▓►↕·→···𝟚↕◄▓·▓▓▓
···▓··²↑········▓▓▓▓
···▓▓▓••▓••▓••▓▓▓···
▓▓▓·················
▓▓▓·················
chunk 19 0
chunk 2 1
chunk 17 5
chunk 0 9
