# Dungeon StoneAge level-10 map 20x11
····················
····················
····················
····••••••►······✥··
····•▓▓▓••••········
···𝟚•▓▓▓·••••·······
···◄𝟚▓▓▓········▓▓▓·
················▓▓▓·
··········²·····▓▓▓·
····················
·········•··········
chunk 5 4
chunk 16 6
