# Dungeon Atomix Ethanal map 13x13
·············
·▓▓▓▓▓▓▓▓▓▓▓·
·▓·········▓·
·▓·▓▓···▓▓·▓·
·▓0·····0··▓·
·▓·▓▓▓·▓▓▓·▓·
·▓0···0····▓·
·▓0▓▓▓0▓▓▓·▓·
·▓·········▓·
·▓·▓▓···▓▓·▓·
·▓··0······▓·
·▓▓▓▓▓▓▓▓▓▓▓·
·············
H↓
C←↑→↓
H↑
H→
C←↑⇉
H↓
O⇇
4 3
1 0 H↓
2 0 H↓
0 1 H→
1 1 C←↑→↓
2 1 C←↑⇉
3 1 O⇇
1 2 H↑
