# Dungeon Atomix Methanol map 13x13
⸳⸳⸳⸳⸳⸳⸳⸳⸳▓▓▓▓
▓▓▓▓⸳⸳⸳⸳⸳▓⸳⸳▓
▓⸳⸳▓⸳⸳⸳⸳⸳▓⸳⸳▓
▓⸳⸳▓▓⸳⸳⸳▓▓⸳0▓
▓⸳⸳0▓▓▓▓▓⸳⸳⸳▓
▓⸳▓⸳▓⸳0▓⸳⸳⸳⸳▓
▓⸳⸳⸳⸳⸳⸳▓⸳0⸳⸳▓
▓⸳⸳▓⸳▓⸳⸳⸳▓⸳⸳▓
▓0⸳⸳⸳⸳⸳⸳⸳⸳⸳⸳▓
▓⸳⸳⸳▓⸳▓⸳⸳⸳▓⸳▓
▓▓▓▓▓▓0⸳⸳⸳▓⸳▓
⸳⸳⸳⸳⸳▓▓▓▓▓▓▓▓
⸳⸳⸳⸳⸳⸳⸳⸳⸳⸳⸳⸳⸳
O←→
H↑
C←↑→↓
H←
H↓
H→
4 3
1 0 H↓
0 1 H→
1 1 C←↑→↓
2 1 O←→
3 1 H←
1 2 H↑
