# Dungeon Atomix Methanal map 13x13
▓▓▓▓▓▓▓▓▓▓▓▓▓
▓0····▓····0▓
▓··▓▓·▓·▓▓··▓
▓▓·▓·····▓·▓▓
▓··▓·····▓··▓
▓·▓▓··▓··▓▓·▓
▓····▓▓▓····▓
▓·▓▓··▓··▓▓·▓
▓··▓·····▓··▓
▓▓·▓·····▓·▓▓
▓··▓▓·▓·▓▓··▓
▓0····▓····0▓
▓▓▓▓▓▓▓▓▓▓▓▓▓
O⇇
C↑↓⇉
H↑
H↓
2 3
0 0 H↓
0 1 C↑↓⇉
1 1 O⇇
0 2 H↑
